18-7
......STTT.......O
.......TTT..S.....
....T..T..........
................SS
@......T........SS
.......TTT........
..................
